##############################
##############################
##############################
########432112344321##########
########+----------+##########
########432112344321##########
##############################
##############################
##############################
##############################
##############################
##############################
##############################
##############################
##############################
